R 1080 720

SO ./img_manage/textures/texture_files/wall_trip_1.xpm

NO ./img_manage/textures/texture_files/wall_trip_2.xpm

EA ./img_manage/textures/texture_files/wall_trip_3.xpm

WE ./img_manage/textures/texture_files/wall_trip_4.xpm

S ./img_manage/textures/texture_files/sprite_trip.xpm


F 255,255,0

C 255,0,255


1111111111  11111111111
1200000021  10000000001
1000000001  10002020001
1200000001  10000000001
1000000021  10000000001
1200W00001  10001110001111111111
10000000211110001 100000000000011
12000000000000001 1000000000000011
10002200000000001 10000200020000011
11111111111111111 100000020002000011
                  100000000200020001
                  10000000000200020011
                  10000000000000000011
                  11111111111111111111
